 --- --- --- --- --- --- --- --- --- 
|               |                   |
     ---                 ---         
|           |           |   |       |
 ---             --- ---     ---     
|       |   |   |                   |
         ---     --- --- ---         
|   |         ^         |           |
         ---         ---     ---     
|   |           |           |       |
 --- --- --- --- --- --- --- --- --- 