 --- --- --- --- --- --- --- --- --- 
|       |       |           |       |
                     ---             
|   |   |   |       |   |       |   |
             --- ---     --- ---     
|   |   |   |     x     |       |   |
                                     
|   |   |   |           |   |   |   |
                 --- ---             
| ^ |       |               |       |
 --- --- --- --- --- --- --- --- --- 