 --- --- --- --- --- --- --- --- --- 
|                                 < |
                                     
|                                   |
                                     
|                                   |
                                     
|                                   |
                                     
|                                   |
 --- --- --- --- --- --- --- --- --- 