 --- --- --- --- --- --- --- --- --- 
|               |                   |
     ---                 ---         
|           |           |   |       |
 ---                 ---     ---     
|       |   |                       |
         ---     --- --- ---         
|   |                   |           |
         ---         ---     ---     
|   |           |           |     < |
 --- --- --- --- --- --- --- --- --- 