 --- --- --- --- --- --- --- --- --- 
|                                   |
                                     
|                                   |
                                     
|                                   |
                                     
|                                   |
                                     
|                                 < |
 --- --- --- --- --- --- --- --- --- 