 --- --- --- --- --- --- --- --- --- 
|                                 v |
                                     
|                                   |
                                     
|                                   |
                                     
|                                   |
                                     
|                                   |
 --- --- --- --- --- --- --- --- --- 