 --- --- --- --- --- --- --- --- --- 
|                                   |
                                     
|                                   |
                                     
|                                   |
                                     
|                                   |
                                     
| ^                                 |
 --- --- --- --- --- --- --- --- --- 