 --- --- --- --- --- --- --- --- --- 
|                                   |
                                     
|                                   |
                                     
|                                   |
                                     
|                                   |
                                     
|                                 ^ |
 --- --- --- --- --- --- --- --- --- 