 --- --- --- --- --- --- --- --- --- 
|               |                   |
     ---                 ---         
|           |           |   |       |
                 --- ---     ---     
|       |   |   |                   |
         ---     --- --- ---         
|   |                   |           |
         ---         ---     ---     
| ^ |           |           |       |
 --- --- --- --- --- --- --- --- --- 