 --- --- --- --- --- --- --- --- --- 
|   |   |   |   |   |   |   |   |   |
 --- --- --- --- --- --- --- --- --- 
|   |                           |   |
 ---     --- --- --- --- ---     --- 
|   |   |                   |   |   |
 ---         --- --- --- ---     --- 
|   | ^ |                       |   |
 --- --- --- --- --- --- --- --- --- 
|   |   |   |   |   |   |   |   |   |
 --- --- --- --- --- --- --- --- --- 