 --- --- --- --- --- --- --- --- --- 
|                                   |
                                     
|                                   |
                                     
|                                   |
                                     
|                                   |
                                     
| >                                 |
 --- --- --- --- --- --- --- --- --- 