 --- --- --- --- --- --- --- --- --- 
|                                   |
     --- --- --- --- --- --- ---     
|   |                           |   |
         --- --- --- --- ---         
|   |   |                   |   |   |
             --- --- --- ---         
|   |   |                       |   |
         --- --- --- --- --- ---     
| ^ |                               |
 --- --- --- --- --- --- --- --- --- 