 --- --- --- --- --- --- --- --- --- 
|               |                   |
     --- ---         --- --- ---     
|           |       |               |
 --- ---     --- ---     --- --- --- 
|           |       |   |           |
     --- ---     ---         ---     
|   |       |       |   |   |       |
             ---                 --- 
|       |           |       |     < |
 --- --- --- --- --- --- --- --- --- 