 --- --- --- --- --- --- --- --- --- 
| v             |                   |
     ---                 ---         
|           |           |   |       |
 ---                 ---     ---     
|       |   |                       |
         ---     --- --- ---         
|   |                   |           |
         ---         ---     ---     
|   |           |           |       |
 --- --- --- --- --- --- --- --- --- 