 --- --- --- --- --- --- --- --- --- 
| v                                 |
                                     
|                                   |
                                     
|                                   |
                                     
|                                   |
                                     
|                                   |
 --- --- --- --- --- --- --- --- --- 