 --- --- --- --- --- --- --- --- --- 
| >                                 |
                                     
|                                   |
                                     
|                                   |
                                     
|                                   |
                                     
|                                   |
 --- --- --- --- --- --- --- --- --- 